11111
10001
10001    101
10001   10001
11011   10001
1000111110001
1000100010001
1000000010001
1000100010001
1000111110001
1000111111011111
1000110000000001
1000110000000001
1000010000000001
1000000000000001
1000010000000001
10N0110000000001
     10000000001
     11111111111
