NO ./png/motif.png
SO ./png/motif.png
WE ./png/motif.png
EA ./png/motif.png
F 200,200,200
C 100,100,100
1111111111111
1001000000001
1000011111E01
1N00110000001
1111111111111
