NO ./png/motif.png;./png/motif.png
SO ./png/planks.png
WE ./png/planks.png
EA ./png/planks.png
DO ./png/planks.png
F 2002,0,200
C 200,,200,200
1111111111111
1001000000001
1000011111001
1N00110000001
1111111111100
