NE
NW
SE
SW
F 255, 0, 0
R 255, 0, 0
1111111111111
1001000000001
1000011111001
1N00110000001
1111111111111
