NO png/wolfenstein_bricks3.png
SO png/wolfenstein_bricks3.png
EA png/wolfenstein_bricks.png
WE png/wolfenstein_bricks2.png
DO png/door.png

F 112,112,112
C 56,56,56

                            1111111111111
     111111                 1000000000001
     100001      1111111111110000000000011111
     1000011     1000000000010000000000010001
     1000001     1000000000000000000000000001
     1000001     1000000000010000000000010001
     11111D11111 1000111111110000000000011111
     10000000001 10001      1000000000001
     1000000000111000111    1111110111111
     1000000000100000001        10001
     1000000000000000001        10001
     1000000000100000001        10001
111111000000000111111111        10001
1000110000000001                10001
1000111111011111           111111000111
10001   10001              1000D0000001
11011   10001              100111000111
1000111110001              1001110001
1000100010001              1001110001
1000000010001              1111110001
1000100010001                   10001
1000111111011111               1110111               1111111111
1000110000000001          111111000001111111         1000000001
1000110000000001          100000000000000011         1000000001
1000110000000001          1000000000000000111111111111000000001
1000010000000001          1000000000000000010000000001000000001
1000000000000001          1000000000000000000000000000000000001
1000010000000001          1000000000000000010000000001000000001
1000110000000001          1000000000000000111100001111000000001
1000110000000001          1000000000000000111110011  1000000001
1000110000000001          11111100000111111   1001   1000000001
1000111111011111               1110111        1001   1111111111
1000111110001                   10001         1001
1000111110001                   10001         1001
1000100010001                   10001         1001
1000000010001                   10001         100111111111111
1000100010001                   10001         100010000000001
1000111110001                   10001         100000000000001
1000111110001111111111111       10001         100010000000001
100000000000000001000000111     10001         111111111111111
100000000000000000000000D01     10001
100000000000000001000000111     10001
111111111111111111D111111       10001
         11100100D001      111111101111111
         100001001011      100001000100001
         11100000111       100000000000001
           11D1111         100001000100001
            1001           100001000100001
            1001           111111000111111
            1111           100001000100001
                           10E0000D0000001
                           100001000100001
                           111111000111111
                           100000000000001
                           100000000000001
                           100000000000001
                           111111111111111
