NO png/releasio.png
SO png/releasio.png
EA png/releasio.png
WE png/releasio.png
DO png/releasio.png

F 250,216,175
C 250,216,175

11111
10001
10001   11111
10001   10001
11D11   10001
1000111110001
1000100010001
1000D00010001
1000100010001
1000111110001
1000111111D11111
1000110000000001
1000110000000001
1000010000000001
10000D0000000001
100001000000N001
1000110000000001
1000110000000001
1111111111111111
