NO png/motif.png;png/motif.png
SO png/planks.png
WE png/planks.png
EA png/planks.png
DO png/planks.png
F 202,0,200
C 200,200,2040
1111111111111 111
1001000000001 101
1000011111001 111
1N00110000000
1111111111111
