NO png/motif.png;
SO png/planks.png
F 200 ,4      , 		200
C 200 , 00 , 200 
WE png/wolfenstein_bricks.png
EA png/brick_wall.png
DO png/door.png
1111111111111
1001000000001
1000011101001
1N00110010101
1000000000001
1111111111111
