NO ./png/motif.png
SO ./png/planks.png
EA ./png/square-32(1).png
WE ./png/square-32.png

F 255,0,0
C 0,255,0

1111
1000
1000
1000
1101
1000
1000
1000
1000
1000
1000
1000
1000
1000
1000
1000
1000
1000
1000
1000
1000
1000
1000
1000
1000
1000
1000
1000
1000
1000
1111
